111111
1P0001
100001
1000E1
10C001
111111