111111
1P0101
100101
100001
101111
1C11E1
111111