1111111111111111111111111111
1P000000000C100000100C001E01
1111111110111000001000001001
100000C000000000001000001001
1000001111100000001000001001
1000000000100000001000001001
10C0000000100000C01000001001
1111111100010011111100001001
1C0000C000000000000000000C01
1111111111111111111111111111
