1111111
11P11C1
1000101
10000E1
1111111