1111111111111111111
1E1P00C0000100000C1
101111111101C100001
10100000C1011100001
1C10111111000001101
1010000000000001C01
1011111111111111101
1000000000000000001
1111111111111111111