1111111111111111111111111111111111111111
1P00001110000000111100000111110000011111
1110110111011100110110111011110111011111
1000110001011000100010100010010001001C01
1101110111011100111011101111011110111101
1100000000000000000000000000010000000001
1110111111011111110111111011110111111011
1000100001000000010000001010010000001C01
1110111011111101110111101111011111011101
1000001000000000000100000000000000000001
1111011111111011111111011111110111111101
1000000000000010000000010000010000000001
1111111011111011101111011101110111111011
1000001010000000001000010000010000001C01
1111011011101111011111011111011111011101
1000000000000000000000000000010000000001
1111110111110111110111110111110111111101
1000000100000000000100000100010000000001
1111111011111011111111011101110111111011
1000000000000000000000000000010000001C01
1111011111111111110111111011110111111101
1000000000000000010000001010010000000001
1110111011111101110111101111011111011101
1C000010000C00000010000000001E0000000001
1111111111111111111111111111111111111111