1111111111111
1P00000000C01
1111111111101
10C0000000001
1011111111111
100000001C001
1111111011101
1E00000000001
1111111111111