111111111111111111111111111111111111
1P00000C0000000C00000000000C00000001
111111111111111111111111111111111101
1000000C0000000000000000000000000001
101111111111111111111111111111111111
100000000000000000000000000000000001
111111111111111111111111111111111101
1C0000000000000000000000000000000EC1
101111111111111111111111111111111111
101111C00C1110000000011111111C000011
1000000000000000000000000000000000C1
111111111111111111111111111111111111