111111111111111111111111111111111111111111111111
1P0000000000000000000000000000000000000000000001
101111001111001111011111001111001111011111000101
10C010001000100001000100010001000010001000100001
10001000111101111111011111011101111101110000C001
101010100010101000101010000010001010100010101001
10000000010001000101000001000010000010000000E001
101111001111001111011111001111001111011111000101
10C010001000100001000100010001000010001000100001
10001000111101111111011111011101111101110000C001
100000000100010001010000010000100000100000000001
100000000000000000000000000000000000000000000001
111111111111111111111111111111111111111111111111