11111111111111111
1P0C0000000000001
100E0000000000001
10000000000000001
11111111111111111