11111111111
1000000C001
100E0000001
100000P0001
11111111111